NO          ./WALL0.xpm
SO          ./WALL0.xpm
EA          ./WALL0.xpm
WE          ./WALL0.xpm

S ./head.xpm
R 1920 1080

F 123,123,123
C 123,123,123


 11111111111111
1000222200000001
1000000000000001
1000222000000001
1000222000000001
1000222000000001
1000222000000001
1000222000000001
1000222000000001
1000222000000001
1000222000000001
1000222000000001
1000222000000001
1000222000000001
1000222000000001
1000000000000N01
 11111111111111