NO          ./textures/WALL0.xpm
SO          ./textures/WALL0.xpm
EA          ./textures/WALL0.xpm
WE          ./textures/WALL0.xpm

S ./textures/head.xpm
R 1920 1080

F 123,123,123
C 123,123,123


 11111111111111
1000222200000001
1000000000000001
1000222000000001
1000222000000001
1000222000000001
1000222000000001
1000222000000001
1000222000000001
1000222000000001
1000222000000001
1000222000000001
1000222000000001
1000222000000001
1000222000000001
1000000000000N01
 11111111111111